Season,Age,Tm,Lg,Pos,G,GS,MP,FG,FGA,FG%,3P,3PA,3P%,2P,2PA,2P%,eFG%,FT,FTA,FT%,ORB,DRB,TRB,AST,STL,BLK,TOV,PF,PTS
2003-04,22,PHI,NBA,SF,74,0,882,115,327,0.352,81,207,0.391,34,120,0.283,0.476,19,24,0.792,30,81,111,40,25,8,41,102,330
2004-05,23,PHI,NBA,SF,82,57,2667,317,759,0.418,226,558,0.405,91,201,0.453,0.567,82,96,0.854,40,339,379,182,103,33,106,265,942
2005-06,24,PHI,NBA,SF,82,43,2563,327,761,0.43,184,438,0.42,143,323,0.443,0.551,101,119,0.849,27,243,270,163,65,26,98,224,939
2006-07,25,PHI,NBA,SF,74,1,2288,372,845,0.44,132,307,0.43,240,538,0.446,0.518,191,209,0.914,30,229,259,105,57,20,117,188,1067
2007-08,26,TOT,NBA,SG-PF,75,0,1732,255,575,0.443,111,296,0.375,144,279,0.516,0.54,119,130,0.915,21,151,172,101,42,29,75,192,740
2008-09,27,UTA,NBA,SF,78,2,1874,245,560,0.438,103,267,0.386,142,293,0.485,0.529,112,127,0.882,35,223,258,137,47,30,90,170,705
2009-10,28,UTA,NBA,SG,52,0,952,138,280,0.493,59,110,0.536,79,170,0.465,0.598,39,49,0.796,10,101,111,89,26,12,42,76,374
2010-11,29,CHI,NBA,SG,82,0,1649,242,557,0.434,120,289,0.415,122,268,0.455,0.542,77,87,0.885,12,138,150,124,35,20,60,156,681
2011-12,30,CHI,NBA,SG,65,7,1469,178,412,0.432,118,271,0.435,60,141,0.426,0.575,55,66,0.833,26,133,159,112,36,15,53,110,529
2012-13,31,ATL,NBA,SF,74,60,2259,277,601,0.461,189,414,0.457,88,187,0.471,0.618,67,78,0.859,23,270,293,146,70,37,70,170,810
2013-14,32,ATL,NBA,SG,71,71,2408,289,609,0.475,185,392,0.472,104,217,0.479,0.626,87,94,0.926,22,260,282,208,70,24,102,147,850
2014-15 â˜…,33,ATL,NBA,SG,75,75,2418,292,600,0.487,221,449,0.492,71,151,0.47,0.671,106,118,0.898,15,289,304,196,52,42,107,140,911
2015-16,34,ATL,NBA,SG,20,20,634,79,161,0.491,39,91,0.429,40,70,0.571,0.612,13,16,0.813,2,79,81,39,16,7,30,39,210
